

SO ./asset/texture_so.xpm

NO ./asset/texture_no.xpm
WE ./asset/texture_we.xpm


EA ./asset/texture_ea.xpm

C 153,219,250
F 247,242,208

111111111111111111111111111111111
100000000000001000000000000000001
101111111111101011111111111011101
10100000001E001010000001010010001
101011111011111011110101010110111
101000001000000000000100010010001
101111101111111011110111011011101
100000100000000000010001010010101
111011111111111111010100010110001
100000000000010101010101010010111
101111110111010101011111111010101
100000010101010001010000100010101
101111010101010111010110101110001
100001010001000101010010001010111
101101011111110101011110111010101
101001010000010001000010001000101
101111010111011111011011101111101
100000010001010001010010000000101
111101111101010101011110111110101
100000000001010101000010100000101
101111111111010111011010101111101
101000000100010000010010100010101
101011110101010111111110111010101
100010010001010100000100101000101
101110111111110111110101101110101
100000000000000000000100001000001
111111111111111111111111111111111