SO ./asset/texture_so.xpm                 
EA ./asset/texture_ea.xpm
WE ./asset/texture_we.xpm
NO ./asset/texture_no.xpm
C 153,219,250
F 247,242,208


 1111111111111 
100000000000001
100000000000001
1000000S0000001
100000000000001
100000000000001
 1111111111111 