

SO ./asset/texture_so.xpm

NO ./asset/texture_no.xpm


C 225,30,0

WE ./asset/texture_we.xpm

F 212,122,222

EA ./asset/texture_ea.xpm




111111111111111111111111
1111111111111110000000011
1011000001110000000000001
100100000000000000000000111111111
111111111011000001110000000000001
100000000011000001110111111111111
1111111111111111111111
11110111111111011100000010001
11110111111111011101010010001
11000000110101011100000010001
10000000000000001100000010001
10000000000000001101010010001
11000001110101011111011110N0111
11110111 1110101 101111010001
11111111 1111111 111111111111
11111

