

SO ./asset/texture_so.xpm

NO ./asset/texture_no.xpm
WE ./asset/texture_we.xpm


EA ./asset/texture_ea.xpm

F 226,135,67
C 171,219,227

1111111111111111
10000000S0000001111111
1000000000000000000001
1001000011111001111111
1001000010001001   101
1001000000001001   101
1001111011111001    1
1000001010000001
1000001011111001
1000000000000001
1111000111111111
   10001
   10001
   10001
   1111