

SO ./asset/texture_so.xpm

NO ./asset/texture_no.xpm
WE ./asset/texture_we.xpm


EA ./asset/texture_ea.xpm

F 244,234,210
C 68,130,188

        1111111111111111111111111
        100000W000110000000000001
        1011000001110000000000001
        1001000000000000000000001
111111111011000001110000000000001
100000000011000001110111111111111
11110111111111011100000010001
11110111111111011101010010001
11000000110101011100000010001
10000000000000001100000010001
10000000000000001101010010001
1100000111010101111101111000111
11110111 1110101 101111010001
11111111 1111111 111111111111