

SO ./asset/texture_so.xpm

NO ./asset/texture_no.xpm



WE ./asset/texture_we.xpm


EA ./asset/texture_ea.xpm

F 0,203,184
C 45,199,0

11111111111111111
10000000000000001
10001000000000001
10000000000100001
1000001100000000111111
1000000000000000000001
1000000N00010000111111
10000000000100001
11111111111111111


