

SO ./asset/texture_so.xpm

NO ./asset/texture_no.xpm



WE ./asset/texture_we.xpm


EA ./asset/texture_ea.xpm

F 0,203,184
C 45,199,0

 1   
 11111111   111111111111
 11111111111111111111101
 10110001111110011100001
 10010001111110000000111111111
 11111111111111101100000100001
 100000011111100011000001110111111111111
 11111111111111111111111111111111111
 11110111111111111111011100000010001
 11110111111111111111011101010010001
 11000001111110110101011100000010001
 10000001111110000000011000000100011
 100010011111100000000001101010010001
 11000001   11110101011111011110N0111
 11110111   11 1110101 101111010001
 11111111   111111111111111111111111
 11111


