

SO ./asset/texture_so.xpm

NO ./asset/texture_no.xpm
WE ./asset/texture_we.xpm


EA ./asset/texture_ea.xpm

F 0,203,0
C 45,199,0

1111111111111111
1000000000000001
1000000000000001
1001000011111001
1001000010001001
1001000000001001
1001111011111001
1000001010000001
1000001011111001
1000000000000001
100000N000000001
1111111111111111