

SO ./asset/texture_so.xpm

NO ./asset/texture_no.xpm



WE ./asset/texture_we.xpm


EA ./asset/texture_ea.xpm

F 0,203,184
C 45,199,255

11111111111111111111
10000000000000000001
10000100000000000001
10000000000000000001
10000000000000000001
10000000000000110001
10000100000000000001
100000000000000N0001
11111111100111111111
        1001
        1001
        1001
        1111