

SO ./asset/texture_so.xpm

NO ./asset/texture_no.xpm



WE ./asset/texture_we.xpm


EA ./asset/texture_ea.xpm

C 73,180,154
F 231,243,240
      
1
1111111111111111
11111111111111101
10110000011100001
10010000000000111111111
11111111101100000100001
100000000011000001110111111111111
11111111111111111111111111111
11110111111111011100000010001
11110111111111011101010010001
1100000011010101110000001000
10000000000000011000000100011
100010000000000001101010010001
11000001110101011111011110N0111
11110111 1110101 101111010001
11111111 1111111 11111111111
11111


